D553D5513B
953A9516C2
87AAC3A93A
A96A96EAAE
AC568556C3
A93D453952
C6C53BAC3A
953BAC47AA
83C6C5556A
EC55555556
