D553D39553
93BA928792
AAAAAAA96A
AC2AAEAC3A
AD6A83C3AE
A956EC52C3
8691553E92
AD6A97C3AE
C556817AC3
D5556C5456
